1111111111111
1001P000P00C1
10EDC11111111
1P0011E0C00C1
1111111111111