1111111111111111111111111111111111111111
10000001000000000000000000000000000000E1
10000010000100000000000000000000000000C1
100C101100000000000000000100000000000001
1001110010010000000010000010000000000001
1000010011000000000000000000000000110001
1000100000111000000000000000000000000001
1000100010001000100000100000000100000001
1001000011000000000000000000010000000001
1110000000100001000000000000000000000001
1001000100010001000100010001000100010001
1010010011001001001001001010100010010011
1000000000000000000000000000000000000001
1101010101010101010101010101010101010101
1010101010101010101010101010101010101001
1P00000000000000000000000000000000000001
1111111111111111111111111111111111111111