1111111111
1000000001
1000000E01
100000010P
1000000C01
1111111111