111111111111111111111
100000000000000000001
100111011111111011101
101000100000101011001
101010101110100110011
101E1000C000000000101
101110111111001111001
100001000110000100011
101000100100111001001
1000101000110010C0111
10100010C100C00010001
101100000100001000001
101010100000100001101
100100001010000100001
110001100100110000001
100100001011000010011
1P0000100000011000001
111111111111111111111