1111111111111111111111111111111111111111
1E0000000000000000C000000000000000000001
111C011111111111111111111111111111111101
11111100101010100C1001000000000000001101
1P000001000100000001111011011101110110C1
1011110100101100000001001110000000000011
101001010100C000000110001110010000111101
1010100010100011000100000010001111001001
1011100100000100010100C00010000100001001
1011001100100010000100000010000000011001
1010011000000000001111110010000001000001
10101000111111110111111111110111C1111111
1011001010100001010001000001010100100001
1010000101010010001100100100010100000001
1010000011001100000100010001000101100001
100100C000000001000000000100001000011001
1111111111111111111111111111111111111111